EA ./textures/east.xpm
NO ./textures/north.xpm
SO ./textures/south.xpm
F 220,100,0
C 100,0,0


WE ./textures/west.xpm

111111111111
10101010101011
11111111111S11
11111111000001
11111111110001 
    1111111111
