EA ./textures/igl64.xpm
NO ./textures/north.xpm
SO ./textures/south.xpm
F 220,100,0
C 0,0,0


WE ./textures/west.xpm

111111111111
10101010101S11
11111111111011
11100000000001
111100011110001
    1111111111
