EA ./textures/east.xpm
WE ./textures/west.xpm
SO ./textures/south.xpm
NO ./textures/north.xpm
C 0,12,67
F 211,9,8

11111111111111111111111111
111111100000000000000000111111
1111110000S0000000000001
111111110000000111111111111
11111111100011111111111
111111111111111111111
