EA ./textures/east.xpm
NO ./textures/north.xpm
SO ./textures/south.xpm
F 220,100,0
C 225,30,0


WE ./textures/west.xpm

11111111111111
LAMAP
